#########
#     ###
# ### ###
# #   ###
# ### ###
#s##e   #
#########
