#############
#         ###
##### ### ###
#       # ###
### # ### ###
#   # #   ###
### ##### ###
#     #   ###
##### ### ###
#s     #  e #
#############
