#########
#     ###
# ### ###
# #   ###
# #######
#s##e   #
#########
