###############
#       # #   #
##### ### # ###
#     #   #   #
##### ### # ###
# #   #     # #
# ### ##### # #
#     # # #   #
##### # # # ###
#             #
##### ### # ###
#     #   #   #
##### ##### ###
#s    #      e#
###############
