###############
#       # #   #
##### ### # ###
#     #   #   #
##### ### # ###
# #   #     # #
# ### ##### # #
#     # # #   #
##### # # # ###
#    xxxxxxx  #
#####x### #x###
#    x#   #x  #
#####x#####x###
#sxxxx#    xxe#
###############
