#########
#xxxxx###
#x###x###
#x#  x###
#x###x###
#s##ex  #
#########
